00000000000000000000
00000000000000000000
00000000000000000000
00000000000000000000
00000000000000000000
GGGGGGGGGGGGGGGGGGGG
GGGGGGGGGGGGGGGGGGGG
00000000000000000000
00000000000000000000
00000000000000000000
00000000000000000000
00000000000000000000
00000000000000000000
00000000000000000000
00000000000000000000
00000000000000000000
00000000000000000000
00000000000000000000
GGGGGGGGGGGGGGGGGGGG
DDDDDDDDDDDDDDDDDDDD
DDDDDDDDDDDDDDDDDDDD