000000000000000000000000000000000000000000000000000000000000
000000000000000000000000000000000000000000000000000000000000
000000000000000000000000000000000000000000000000000000000000
000000000000000000000000000000000000000000000000000000000000
00000GGGGG00000000000000000000000000000000000000000000000000
000000000000000000000000000000000000000000000000000000000000
000000000000000000000000000000000000000000000000000000000000
000000DD0D00000000000000000000000000000000000000000000000000
0000000000DD0GGGGG000000000000000000000000000000000000000000
000000000000000DDDD00000000000000000000000000000000000000000
00000000000000DDDDD00000000000000000000000000000000000000000
000000000000000000000000000000000000000000000000000000000000
000000000000000000000000000000000000000000000000000000000000
000000000000000000000000000000000000000000000000000000000000
000000000000000000000000000000000000000000000000000000000000
000000000GGGGGGGGGGGG000000000000000000000000000000000000000
000000000000000000000000000000000000000000000000000000000000
00000000000000000000000000GGGGGGG000000000000000000000000000
GGGGGGGGGGGGGGGGGGGGGGGGGGDDDDDDDGGGGGGGGGGGGGGGGGGGGGGGGGGG
DDDDDDDDDDDDDDDDDDDDDDDDDDDDDDDDDDDDDDDDDDDDDDDDDDDDDDDDDDDD
DDDDDDDDDDDDDDDDDDDDDDDDDDDDDDDDDDDDDDDDDDDDDDDDDDDDDDDDDDDD