000000000000000000000000000000000G00000000000000000000000000
000000000000000000000000000000000000000000000000000000000000
0000000000G0000000000000000000000000000000000000000000000000
000000000000000000000000000000000000000000000000000000000000
0000000000GGGGGGGGGGG000000000000000000000000000000000000000
00000000000000000GGGG000000000000000000000000000000000000000
000G000000000000GGGGG000000000000000000000000000000000000000
00000000G00000000GGGG000000000000000000000000000000000000000
000000000000000000000000000000000000000000000000000000000000
00000G000000000000000000000000000000000000000000000000000000
000000000000000000000000000000000000000000000000000000000000
000000000000000000000000000000000000000000000000000000000000
000000000000000000000000000000000000000000000000000000000000
000000000000000000000000000000000000000000000000000000000000
000000000000000000000000000000000000000000000000000000000000
000000000GGGGGGGGGGGG000000000000000000000000000000000000000
000000000000000000000000000000000000000000000000000000000000
00000000000000000000000000GGGGGGG000000000000000000000000000
GGGGGGGGGGGGGGGGGGGGGGGGGGDDDDDDDGGGGGGGGGGGGGGGGGGGGGGGGGGG
DDDDDDDDDDDDDDDDDDDDDDDDDDDDDDDDDDDDDDDDDDDDDDDDDDDDDDDDDDDD
DDDDDDDDDDDDDDDDDDDDDDDDDDDDDDDDDDDDDDDDDDDDDDDDDDDDDDDDDDDD